NO ./textures/north.xpm
SO ./textures/south.xpm
WE ./textures/west.xpm
EA ./textures/east.xpm

F 220,100,0
C 255,255,255

111111111111
100000000001
10000N000001
1000000E0001
111111111111
