NO ./img/1.xpm
SO ./img/2.xpm
EA ./img/3.xpm
WE ./img/4.xpm

F 255,200,100
C 60,100,100





        11111111111111111111111111
        1000000000011001 100000001
        1011000001110001 10000001
        1100000000000100100001111
1111111110110000011100000000000001
100000000011000001110111110111111
11110111111111011100000010001
11110111111111011101010010001
1111111111111111111111101111 
 100011     1000111111111
11111111111111111111111101111
10000001101010111111111000001
1000000000000000110000N010001
10000000000000001101010010001
110000011101010111111111000111
11111111 1111111  11111111111
11111111 1111111  11111111111