NO ./img/greystone.xpm
SO ./img/greystone.xpm
EA ./img/greystone.xpm
WE ./img/greystone.xpm

F 180,120,80
C 40,40,100

111111111111111111111111111111111
100000000000000000000000000000001
100011100011111100011100011100001
100010000010000100010000010000001
100010000010000100010000010000001
1000S0000010000100000000010000001
100011100011111100011100011100001
100000000000000000000000000000001
111111111111111111111111111111111
