NO ./img/MARBFACE.xpm
SO ./img/MARBLE2.xpm
EA ./img/MARBLE3.xpm
WE ./img/WALL.xpm
F 220,100,0
C 50,50,150

111111111111111111111111111111111
100000000011000011000000100000001
100000000011000011000000100000001
100000000011000011000000100000001
10000000000000S000000000100000001
100000000011000000000000100000001
100000000011000000000000100000001
100000000011000000000000100000001
100000000011000011000000100000001
111111111111111111111111111111111
